22 3
111111111111111111111111111111111111111
100000000000000000000000000000000000001
100000000000000000000000000000000000001
100000000000000000000000000000000000001
100011111000111111111111000111111111111
111111111000111111111111000111111111111
111111111000111111111111000111111111111
111111111000000000000000000000000000001
111111111000111111111111000111111111111
111111111000111111111111000111111111111
100111111000111111111111000111111111111
100000000000000000000000000000000000001
100000000000000000000000000000000000001
100000000000000000000000000000000000001
111111111111111111111111111111111111111